10.ox
......o.o................o..o.o....o.....o.o........oo..o....o...o...oo....o.....o..o..................o........o...o..o.....o.o......o.......o........o......o.......o.......o...o.....o...o.......o..........o..o............o.....................o....o..o.o.........................o........o.o......o..oo..o..o.oo..o.oo....o...oo.....o........o......oo..o......o....o..................oo.............
.........o.........o..o.....................o....o.......o......................o..oo.o.....o...o....o...o..............oo.o.......oo.....o.o.....o....oooo....oo....o...........ooo....o.o..........o.............o.....o..o....o.....o.o.o.......o.....o.o.....o....o.o..o...................oo..o.o.......o..o.....ooo..o...o.....o...o....o..o.o.o.......oo........o.oo...ooo..o...oo......oo........o......
.....o...o...............o...o.....o..o....oo.oo.......o.......o..o..o...o..o.o..........o...o....oo....o.....o.......................oo..o.............oo.o.o......o...oo................o.........o..o........o...o...o......o.............o..........o..o.........o...o..o......oo.......ooo.oo.o........o....o...o......o........o....o....o..o.o..o.o..............oo......o..............oo..........o....
.....o...o...........ooo..oo..oo.o.......o....................o........o..oo....o.......o....o...o...o............oo..o.....o....o.....o..o.o..oo..............o.o....oo..o.......o...o...o...ooo...o....o.....o....o.....o.......ooo................o..o.o....oo................o..oo........o....o..o...oo.o............ooo.o...............o...o.o.....oo.o...o...................o....o...........o.....o...
o.o....o............o........o..o...o.o........oo.................oo.o...o...oo.o...o......o..........o.o.............o...o..o...o.o.............o...............o..o...o........o......o...o....o.oo.....o.o.o.....o..o......oo.......o...o..............o.....o....o....o..........o........o.....o.....o.o.....o.o..o...................o.........o...o.o..........o.....o.............o....o........o.o...o.
oo..o..o..o.ooo..........o..o............ooo........o.........o..o.....oo.o....o..o...........o..o...o...o...o....o...o.o....ooo....o.....o..o.....oo.....o......o.o...............o....o......o.............oo......ooo..........o.o..o..........o..oo......o.o.......o..oo.o....o..o......o..o.o.o........o.oo....o....oo..........o.o.....o..................o............o..o...o.....o............o...o....
..........oo..oo...............................oo......o..o...o.............o..o..o.........o...o...........o...........o.........oo...o......o...o...o....o..o.....o..o..........o..o...........o.o.o..........oo..o.o........o.....o.......o......o...o.o...oo........o...o.....o.o..oo.o.............o...........o.....o.o.ooo......o.............oo..oo...o...o.......o........o.oo............o...o....o...
...o.o......o.o.....o..oo...o..o....o......o........o..o............o..o.o....oo...oo............ooo....o.o.o..ooo.....................ooooo........................o.o..o......o...........oo.oo.o..o..o..o.........o.......o.o.o...............o.o...............o..o....o..........oo.......o........oo..o.........o.....o.o.o....o..o...o....o.o..oo......o...........o..o.....oo..o......oo..o...oo..o...o.
..o.o........o.......o...o....oo......o.....o..o.o..........o....o.o......oo....................o...................o........o....oo.......o.........................o.ooo..oo.......o.o..oo.....o....o......o..o...o...o...o...........o.o...o....................o...........o.o.o.o.....o..o..ooo.........o.......oo.....oo..........o......o..........o.............o....o.o....o..o..............oo........
.................o.....o.o...........o.o.....o............o.oo......o.o..oo...oo..o....o.........o.o...o..oo.o...o........o...........o......o...............o.......o....o.oo..oo...oo...o.o......o.........oo.o.....o....o......o..o...ooo..o....o.o............o.o.o....o...o...o........o.o...o..o........o...o...o..o.....o..oo....oo..o...o.o....o......o.........oo.o.........o.....o....o......o.....o..
